[forensicstore_schemas]
artifact = forensicstore_stix_schemas:artifact
attack-pattern = forensicstore_stix_schemas:attack_pattern
autonomous-system = forensicstore_stix_schemas:autonomous_system
binary = forensicstore_stix_schemas:binary
bundle = forensicstore_stix_schemas:bundle
campaign = forensicstore_stix_schemas:campaign
core = forensicstore_stix_schemas:core
course-of-action = forensicstore_stix_schemas:course_of_action
cyber-observable-core = forensicstore_stix_schemas:cyber_observable_core
dictionary = forensicstore_stix_schemas:dictionary
directory = forensicstore_stix_schemas:directory
domain-name = forensicstore_stix_schemas:domain_name
email-addr = forensicstore_stix_schemas:email_addr
email-message = forensicstore_stix_schemas:email_message
external-reference = forensicstore_stix_schemas:external_reference
file = forensicstore_stix_schemas:file
granular-marking = forensicstore_stix_schemas:granular_marking
grouping = forensicstore_stix_schemas:grouping
hashes = forensicstore_stix_schemas:hashes
hex = forensicstore_stix_schemas:hex
identifier = forensicstore_stix_schemas:identifier
identity = forensicstore_stix_schemas:identity
indicator = forensicstore_stix_schemas:indicator
infrastructure = forensicstore_stix_schemas:infrastructure
intrusion-set = forensicstore_stix_schemas:intrusion_set
ipv4-addr = forensicstore_stix_schemas:ipv4_addr
ipv6-addr = forensicstore_stix_schemas:ipv6_addr
kill-chain-phase = forensicstore_stix_schemas:kill_chain_phase
language-content = forensicstore_stix_schemas:language_content
location = forensicstore_stix_schemas:location
mac-addr = forensicstore_stix_schemas:mac_addr
malware = forensicstore_stix_schemas:malware
malware-analysis = forensicstore_stix_schemas:malware_analysis
marking-definition = forensicstore_stix_schemas:marking_definition
mutex = forensicstore_stix_schemas:mutex
network-traffic = forensicstore_stix_schemas:network_traffic
note = forensicstore_stix_schemas:note
observed-data = forensicstore_stix_schemas:observed_data
opinion = forensicstore_stix_schemas:opinion
process = forensicstore_stix_schemas:process
properties = forensicstore_stix_schemas:properties
relationship = forensicstore_stix_schemas:relationship
report = forensicstore_stix_schemas:report
sighting = forensicstore_stix_schemas:sighting
software = forensicstore_stix_schemas:software
threat-actor = forensicstore_stix_schemas:threat_actor
timestamp = forensicstore_stix_schemas:timestamp
tool = forensicstore_stix_schemas:tool
url = forensicstore_stix_schemas:url
url-regex = forensicstore_stix_schemas:url_regex
user-account = forensicstore_stix_schemas:user_account
vulnerability = forensicstore_stix_schemas:vulnerability
windows-registry-key = forensicstore_stix_schemas:windows_registry_key
x509-certificate = forensicstore_stix_schemas:x509_certificate

